111111111111111111111111111111
100000000000000000000000000001
100000000000000000000000000001
100000000000000000000000000001
100000000000000000000000000001
100000000000000000000000000001
100000000000000000000000000001
100000000000000000000000000001
100000000000000000000000000001
10000003000000000303000000001
100000000000000003330000000001
100000000000000003300000000001
100000000000000000000000000001
100000000000000000000000000001
100000000000000000000000000001
100000000000000000000000220001
100000000000000000000002222201
100000000000000000000000022001
100000000000000000000000000001
111111111111111111111111111111